TYPE
CPU

RESULTS
TOTAL TIME
0.390309

MAP
DIM 100 5
8 9 8 7 5 
7 5 5 0 2 
3 0 2 1 7 
1 5 5 7 0 
6 1 5 6 7 
3 1 0 5 8 
6 0 0 7 7 
7 1 7 6 7 
3 8 3 7 7 
4 2 1 8 6 
9 4 9 5 8 
9 9 6 1 4 
4 6 8 2 2 
4 7 6 8 2 
7 3 3 3 0 
2 7 5 1 4 
3 2 9 4 9 
6 4 7 3 5 
3 3 0 4 3 
1 4 5 9 0 
7 6 9 6 9 
7 0 3 2 4 
1 2 5 1 9 
7 0 0 4 8 
4 7 6 1 8 
2 0 4 1 5 
7 0 4 2 6 
7 3 4 8 4 
4 1 7 6 6 
3 0 2 7 0 
7 8 3 3 9 
3 1 4 1 3 
2 1 4 0 9 
4 1 2 0 2 
8 6 1 5 6 
9 8 5 7 0 
4 3 5 1 4 
7 6 6 1 7 
4 1 3 9 4 
6 4 9 5 7 
0 2 5 0 6 
0 2 3 5 7 
8 7 5 1 0 
7 3 1 6 2 
7 2 1 3 2 
5 5 6 5 9 
7 3 3 7 2 
2 1 4 6 5 
1 9 4 3 4 
4 5 8 7 3 
8 4 8 5 6 
7 4 7 0 5 
0 2 2 5 6 
1 7 9 9 0 
5 0 4 6 3 
7 5 9 2 0 
1 6 1 9 8 
4 8 8 6 3 
8 3 3 3 3 
6 9 0 5 2 
8 1 4 4 2 
4 5 2 4 2 
8 7 1 5 6 
7 2 3 2 5 
8 6 3 3 8 
8 9 7 7 4 
2 2 7 1 0 
9 6 0 3 7 
2 3 6 5 2 
5 4 0 6 3 
6 0 1 0 7 
2 5 1 1 8 
2 0 9 9 0 
8 8 1 4 6 
7 1 3 0 1 
9 2 2 4 1 
6 9 1 1 7 
9 9 5 7 1 
3 5 9 6 4 
9 3 7 1 2 
6 8 1 4 2 
8 0 4 3 1 
1 1 1 2 1 
1 8 3 3 4 
6 5 4 7 0 
2 4 5 5 4 
1 6 8 3 9 
2 0 6 2 1 
5 0 8 9 3 
5 0 7 2 9 
8 5 2 1 8 
1 9 5 2 0 
2 9 1 9 2 
1 4 2 3 0 
0 6 0 1 9 
7 1 3 6 8 
7 9 9 4 7 
5 3 9 4 4 
8 5 5 6 1 
3 4 2 6 7 

PATH
499
494
489
488
483
478
473
468
467
462
457
452
453
448
443
438
433
428
423
418
413
414
409
404
399
394
389
384
383
382
377
372
367
362
357
358
359
354
349
344
343
338
333
328
323
318
317
312
307
302
301
296
291
286
285
280
275
270
265
266
261
256
251
246
245
240
235
236
231
226
221
216
211
206
201
196
191
186
181
182
177
172
167
166
161
156
157
152
147
142
137
132
133
128
123
118
113
108
103
98
93
88
83
78
73
68
63
58
53
48
47
46
45
40
35
30
25
20
15
10
5
EOF
