MAP
DIM 7 7
10 10 10 10 10 10 10 
999 999 999 999 999 999 10 
999 999 10 10 10 10 10 
10 10 10 0 999 999 999 
10 10 0 10 10 10 10 
10 10 10 10 999 999 10 
10 10 0 0 0 999 10 
PATH
48
41
34
33
32
31
38
37
36
29
22
23
16
17
18
19
20
13
6
5
4
3
2
1
EOF
