TYPE
CPU

RESULTS
TOTAL TIME
0.031722

MAP
DIM 10 10
8 9 8 7 5 7 5 5 0 2 
3 0 2 1 7 1 5 5 7 0 
6 1 5 6 7 3 1 0 5 8 
6 0 0 7 7 7 1 7 6 7 
3 8 3 7 7 4 2 1 8 6 
9 4 9 5 8 9 9 6 1 4 
4 6 8 2 2 4 7 6 8 2 
7 3 3 3 0 2 7 5 1 4 
3 2 9 4 9 6 4 7 3 5 
3 3 0 4 3 1 4 5 9 0 

PATH
98
88
78
68
58
57
47
46
36
26
25
15
14
13
12
22
21
20
10
EOF
